- - - - - - - - - - - - - - - - - - - - - - - - - - - - - - - - - - - - - - - - - - - - - - - -
- - - - - - - - - - - - - - - - - - - - - - - - - - - - - - - - - - - - - - - - - - - - - - - -
- - - - - - - - - - - - - - - - - - - - - - - - - - - - - - - - - - - - - - - - - - - - - - - -
- - - - - - - - - - - - - - - * * * * - - * * - - - - - - - - - - - - - - - - - - - - - - - - -
- - - - - - - - - - - * * - - - - - - - - - - - * * - - - - - - - - - - - - - - - - - - - - - -
- - - - - - - - - * * * * - - - - - - - - - - - - - - - - - - - - - - - - - - - - - - - - - - - -
- - - - - - - - - - - - - - - - - - - - - - - - - - - * * - - - - - - - - - - - - - - - - - - -
- - - - - - * * - - - - - - - - - - - - - - - - - - - - - - - - - - - - - - - - - - - - - - * *
- - - - - - * * - - - - - - - - - - - - - - - - - - - - - * * - - - - - - - - - - - * * - - - -
- - - - - - - - - - - - - - - - - - - * - - - - - - - - - - - - * * - - - - * * - - - - - - - -
- - - - - - - - - - - - - - - - - - * * * - - - - - - - - - - - - - - - - - - - - - - - - - - -
- - - - - - - - - * * - - - - - - * * * * * - - - - - - - - - - - - - * * - - - - - - - - - - -
- - - - - - - - - * * - 0 - - - * * * * * * * - - - - - - - - - - - - 1 - - - - - - - - - - - -
* * * * * * * * * * * * * * * * * * * * * * * * * * * - - * * * * * * * * * * * * * * * * * * *
* * * * * * * * * * * * * * * * * * * * * * * * * * * - - * * * * * * * * * * * * * * * * * * *